//MAP CONVERTED BY dmm2tgm.py THIS HEADER COMMENT PREVENTS RECONVERSION, DO NOT REMOVE
"a" = (
/turf/open/floor/almayer/plating2/west,
/area/shuttle/cargo/elevator)
"d" = (
/turf/open/shuttle/escapepod{
	dir = 1
	},
/area/shuttle/cargo/elevator)
"g" = (
/turf/open/floor/almayer/plating2/northwest,
/area/shuttle/cargo/elevator)
"h" = (
/turf/open/shuttle/escapepod/floor2/east,
/area/shuttle/cargo/elevator)
"j" = (
/obj/docking_port/mobile/cargo,
/turf/closed/shuttle/elevator{
	dir = 10
	},
/area/shuttle/cargo/elevator)
"o" = (
/turf/open/floor/almayer/plating2/north,
/area/shuttle/cargo/elevator)
"q" = (
/turf/closed/shuttle/elevator{
	dir = 4
	},
/area/shuttle/cargo/elevator)
"s" = (
/turf/open/shuttle/escapepod/floor0/north{
	dir = 4
	},
/area/shuttle/cargo/elevator)
"w" = (
/obj/structure/machinery/computer/shuttle/cargo{
	pixel_y = 33;
	req_one_access = list(19,21);
	pixel_x = -1;
	req_access = list()
	},
/turf/open/floor/almayer/plating2/north,
/area/shuttle/cargo/elevator)
"x" = (
/turf/open/floor/almayer/plating2/northeast,
/area/shuttle/cargo/elevator)
"z" = (
/turf/open/floor/almayer/plating2/east,
/area/shuttle/cargo/elevator)
"A" = (
/turf/open/shuttle/escapepod,
/area/shuttle/cargo/elevator)
"B" = (
/turf/closed/shuttle/elevator{
	dir = 6
	},
/area/shuttle/cargo/elevator)
"E" = (
/turf/open/floor/almayer/plating2/southeast,
/area/shuttle/cargo/elevator)
"F" = (
/turf/closed/shuttle/elevator{
	dir = 8
	},
/area/shuttle/cargo/elevator)
"G" = (
/turf/open/shuttle/escapepod/floor2/west,
/area/shuttle/cargo/elevator)
"H" = (
/turf/closed/shuttle/elevator/gears,
/area/shuttle/cargo/elevator)
"I" = (
/turf/open/floor/almayer/plating2/south,
/area/shuttle/cargo/elevator)
"J" = (
/turf/open/floor/almayer/plating2/southwest,
/area/shuttle/cargo/elevator)
"L" = (
/turf/closed/shuttle/elevator,
/area/shuttle/cargo/elevator)
"M" = (
/turf/closed/shuttle/elevator/freight,
/area/shuttle/cargo/elevator)
"Q" = (
/obj/structure/machinery/door/poddoor/hybrisa/shutters{
	dir = 4;
	id = "east"
	},
/turf/open/floor/almayer/test_floor4,
/area/shuttle/cargo/elevator)
"T" = (
/turf/closed/shuttle/elevator{
	dir = 5
	},
/area/shuttle/cargo/elevator)
"U" = (
/obj/structure/machinery/door/poddoor/hybrisa/shutters{
	dir = 4;
	id = "east"
	},
/turf/open/floor/almayer/test_floor6,
/area/shuttle/cargo/elevator)
"V" = (
/turf/closed/shuttle/elevator/button/freight,
/area/shuttle/cargo/elevator)
"W" = (
/turf/open/shuttle/escapepod/floor0/west,
/area/shuttle/cargo/elevator)
"X" = (
/turf/closed/shuttle/elevator{
	dir = 9
	},
/area/shuttle/cargo/elevator)

(1,1,1) = {"
X
L
L
L
L
L
L
L
L
L
L
j
"}
(2,1,1) = {"
H
g
a
a
a
a
a
a
a
a
J
H
"}
(3,1,1) = {"
V
w
s
d
d
d
d
d
d
h
I
F
"}
(4,1,1) = {"
M
o
G
A
A
A
A
A
A
W
I
q
"}
(5,1,1) = {"
H
x
z
z
z
z
z
z
z
z
E
H
"}
(6,1,1) = {"
T
U
Q
U
U
U
U
U
U
Q
U
B
"}
