//MAP CONVERTED BY dmm2tgm.py THIS HEADER COMMENT PREVENTS RECONVERSION, DO NOT REMOVE
"aa" = (
/turf/closed/shuttle/saigon{
	icon_state = "103";
	dir = 4
	},
/area/shuttle/saigon)
"ab" = (
/turf/closed/shuttle/saigon{
	icon_state = "103"
	},
/area/shuttle/saigon)
"ac" = (
/obj/structure/platform_decoration/metal/almayer/north,
/turf/open/shuttle/dropship{
	icon_state = "rasputin3"
	},
/area/shuttle/saigon)
"ad" = (
/obj/structure/machinery/door/airlock/multi_tile/almayer/dropshiprear/dropshipside/ds2{
	dir = 2;
	name = "\improper Saigon crew hatch";
	id = "port_door"
	},
/obj/structure/blocker/forcefield/multitile_vehicles,
/turf/open/shuttle/dropship{
	icon_state = "rasputin15"
	},
/area/shuttle/saigon)
"ae" = (
/obj/structure/machinery/door/airlock/multi_tile/almayer/dropshiprear/dropshipside/ds2{
	dir = 1;
	name = "\improper Saigon crew hatch"
	},
/obj/structure/blocker/forcefield/multitile_vehicles,
/turf/open/shuttle/dropship{
	icon_state = "rasputin15"
	},
/area/shuttle/saigon)
"af" = (
/obj/structure/bed/chair/vehicle{
	pixel_x = 8
	},
/obj/structure/bed/chair/vehicle{
	pixel_x = -8
	},
/obj/structure/extinguisher_cabinet/alt{
	pixel_y = 26
	},
/turf/open/shuttle/dropship{
	icon_state = "rasputin15"
	},
/area/shuttle/saigon)
"ag" = (
/obj/structure/bed/chair/vehicle{
	pixel_x = 8
	},
/obj/structure/bed/chair/vehicle{
	pixel_x = -8
	},
/obj/structure/machinery/cm_vending/sorted/medical/wall_med/vehicle{
	pixel_y = 25
	},
/turf/open/shuttle/dropship{
	icon_state = "rasputin15"
	},
/area/shuttle/saigon)
"ah" = (
/obj/structure/shuttle/part/dropship2/left_outer_wing_connector,
/turf/template_noop,
/area/shuttle/saigon)
"ai" = (
/turf/closed/shuttle/saigon{
	icon_state = "94";
	dir = 1
	},
/area/shuttle/saigon)
"aq" = (
/obj/effect/attach_point/weapon/saigon/right_fore,
/obj/structure/shuttle/part/dropship2/transparent/outer_right_weapons,
/turf/template_noop,
/area/shuttle/saigon)
"aK" = (
/obj/structure/shuttle/part/dropship2/nose_front_left,
/turf/template_noop,
/area/shuttle/saigon)
"bo" = (
/obj/structure/bed/chair/vehicle{
	pixel_x = 8
	},
/obj/structure/bed/chair/vehicle{
	pixel_x = -8
	},
/turf/open/shuttle/dropship{
	icon_state = "rasputin15"
	},
/area/shuttle/saigon)
"bR" = (
/obj/structure/machinery/computer/groundside_operations{
	dir = 4;
	pixel_x = -17;
	pixel_y = 10
	},
/obj/structure/machinery/computer/overwatch/almayer{
	dir = 8;
	pixel_x = -17;
	pixel_y = -6
	},
/obj/structure/barricade/handrail{
	dir = 4
	},
/obj/structure/bed/chair/vehicle{
	dir = 8
	},
/turf/open/shuttle/dropship{
	icon_state = "rasputin15"
	},
/area/shuttle/saigon)
"ct" = (
/obj/structure/machinery/light/dropship/red{
	dir = 8
	},
/obj/structure/shuttle/part/dropship2/transparent/middle_left_wing,
/turf/template_noop,
/area/shuttle/saigon)
"ee" = (
/obj/structure/shuttle/part/dropship2/transparent/engine_left_exhaust,
/turf/template_noop,
/area/shuttle/saigon)
"fd" = (
/turf/closed/shuttle/saigon{
	icon_state = "94"
	},
/area/shuttle/saigon)
"fw" = (
/obj/structure/stairs/perspective{
	icon_state = "p_stair_full"
	},
/obj/structure/platform{
	dir = 8
	},
/turf/open/shuttle/dropship{
	icon_state = "rasputin3"
	},
/area/shuttle/saigon)
"fz" = (
/obj/effect/attach_point/fuel/saigon{
	dir = 1
	},
/turf/closed/shuttle/saigon/transparent{
	icon_state = "28"
	},
/area/shuttle/saigon)
"fD" = (
/turf/closed/shuttle/saigon/transparent{
	icon_state = "22"
	},
/area/shuttle/saigon)
"fT" = (
/turf/closed/shuttle/saigon{
	icon_state = "25"
	},
/area/shuttle/saigon)
"gA" = (
/obj/structure/platform{
	dir = 8
	},
/turf/open/shuttle/dropship{
	icon_state = "rasputin3"
	},
/area/shuttle/saigon)
"is" = (
/obj/structure/shuttle/part/dropship2/transparent/nose_center,
/turf/template_noop,
/area/shuttle/saigon)
"js" = (
/turf/closed/shuttle/saigon/transparent{
	icon_state = "35"
	},
/area/shuttle/saigon)
"jB" = (
/turf/closed/shuttle/saigon{
	icon_state = "30"
	},
/area/shuttle/saigon)
"kY" = (
/turf/closed/shuttle/saigon/transparent{
	icon_state = "86"
	},
/area/shuttle/saigon)
"mb" = (
/obj/structure/blocker/forcefield/multitile_vehicles,
/obj/structure/platform{
	dir = 8
	},
/turf/open/shuttle/dropship{
	icon_state = "rasputin4"
	},
/area/shuttle/saigon)
"mq" = (
/obj/structure/shuttle/part/dropship2/transparent/engine_right_exhaust,
/turf/template_noop,
/area/shuttle/saigon)
"mN" = (
/turf/open/shuttle/dropship{
	icon_state = "rasputin3"
	},
/area/shuttle/saigon)
"mS" = (
/turf/closed/shuttle/saigon/transparent{
	icon_state = "34"
	},
/area/shuttle/saigon)
"ob" = (
/turf/closed/shuttle/saigon{
	icon_state = "83"
	},
/area/shuttle/saigon)
"oI" = (
/obj/structure/shuttle/part/dropship2/transparent/left_outer_inner_wing,
/turf/template_noop,
/area/shuttle/saigon)
"pV" = (
/obj/structure/machinery/light/dropship/green{
	dir = 4
	},
/obj/structure/shuttle/part/dropship2/transparent/middle_right_wing,
/turf/template_noop,
/area/shuttle/saigon)
"qc" = (
/obj/structure/stairs/perspective{
	icon_state = "p_stair_full"
	},
/obj/structure/platform{
	dir = 4
	},
/turf/open/shuttle/dropship{
	icon_state = "rasputin3"
	},
/area/shuttle/saigon)
"qp" = (
/obj/effect/attach_point/weapon/saigon/left_fore,
/obj/structure/shuttle/part/dropship2/transparent/outer_left_weapons,
/turf/template_noop,
/area/shuttle/saigon)
"qP" = (
/obj/structure/blocker/forcefield/multitile_vehicles,
/turf/open/shuttle/dropship{
	icon_state = "rasputin8"
	},
/area/shuttle/saigon)
"ru" = (
/turf/closed/shuttle/saigon{
	icon_state = "72"
	},
/area/shuttle/saigon)
"rB" = (
/obj/structure/shuttle/part/dropship2/transparent/right_outer_bottom_wing,
/turf/template_noop,
/area/shuttle/saigon)
"se" = (
/turf/closed/shuttle/saigon{
	icon_state = "82"
	},
/area/shuttle/saigon)
"st" = (
/turf/closed/shuttle/saigon{
	icon_state = "48"
	},
/area/shuttle/saigon)
"ti" = (
/obj/structure/shuttle/part/dropship2/right_inner_wing_connector,
/turf/template_noop,
/area/shuttle/saigon)
"tj" = (
/obj/docking_port/mobile/marine_dropship/saigon,
/turf/open/shuttle/dropship{
	icon_state = "rasputin15"
	},
/area/shuttle/saigon)
"ul" = (
/turf/open/shuttle/dropship{
	icon_state = "floor8"
	},
/area/shuttle/saigon)
"uo" = (
/turf/closed/shuttle/saigon/transparent{
	icon_state = "98"
	},
/area/shuttle/saigon)
"uw" = (
/turf/closed/shuttle/saigon{
	icon_state = "62"
	},
/area/shuttle/saigon)
"uF" = (
/obj/structure/shuttle/part/dropship2/nose_front_right,
/turf/template_noop,
/area/shuttle/saigon)
"vv" = (
/turf/closed/shuttle/saigon/transparent{
	icon_state = "38"
	},
/area/shuttle/saigon)
"wD" = (
/obj/structure/bed/chair/vehicle{
	pixel_x = 8
	},
/obj/structure/bed/chair/vehicle{
	pixel_x = -8
	},
/obj/structure/machinery/camera/autoname/almayer/attu{
	dir = 8;
	pixel_x = 1
	},
/turf/open/shuttle/dropship{
	icon_state = "rasputin15"
	},
/area/shuttle/saigon)
"xx" = (
/obj/structure/machinery/cm_vending/sorted/cargo_guns/squad{
	req_access = null;
	req_one_access = null;
	pixel_y = 30;
	density = 0
	},
/turf/open/shuttle/dropship{
	icon_state = "rasputin6"
	},
/area/shuttle/saigon)
"zC" = (
/obj/structure/machinery/cm_vending/sorted/cargo_guns/squad_prep{
	req_access = null;
	req_one_access = null;
	pixel_y = 30;
	density = 0
	},
/turf/open/shuttle/dropship{
	icon_state = "rasputin7"
	},
/area/shuttle/saigon)
"zF" = (
/obj/structure/platform{
	dir = 1;
	layer = 2.8
	},
/turf/open/shuttle/dropship{
	icon_state = "rasputin15"
	},
/area/shuttle/saigon)
"Af" = (
/obj/structure/blocker/invisible_wall,
/obj/structure/machinery/computer/shuttle/dropship/flight,
/turf/open/shuttle/dropship{
	icon_state = "rasputin15"
	},
/area/shuttle/saigon)
"AP" = (
/turf/closed/shuttle/saigon/transparent{
	icon_state = "29"
	},
/area/shuttle/saigon)
"Bc" = (
/obj/effect/attach_point/weapon/saigon/left_wing,
/obj/structure/shuttle/part/dropship2/transparent/lower_left_wing,
/turf/template_noop,
/area/shuttle/saigon)
"BN" = (
/obj/structure/blocker/invisible_wall,
/obj/structure/machinery/computer/cameras/dropship/saigon,
/obj/structure/machinery/camera/autoname/almayer/attu{
	dir = 4
	},
/turf/open/shuttle/dropship{
	icon_state = "rasputin15"
	},
/area/shuttle/saigon)
"Ch" = (
/obj/structure/bed/chair/vehicle{
	dir = 1;
	pixel_x = -8
	},
/obj/structure/bed/chair/vehicle{
	dir = 1;
	pixel_x = 8
	},
/turf/open/shuttle/dropship{
	icon_state = "rasputin15"
	},
/area/shuttle/saigon)
"Cw" = (
/turf/closed/shuttle/saigon/transparent{
	icon_state = "39"
	},
/area/shuttle/saigon)
"Dz" = (
/obj/structure/bed/chair/dropship/pilot{
	dir = 1
	},
/turf/open/shuttle/dropship{
	icon_state = "rasputin15"
	},
/area/shuttle/saigon)
"Ed" = (
/obj/structure/shuttle/part/dropship2/left_inner_wing_connector,
/turf/template_noop,
/area/shuttle/saigon)
"ED" = (
/obj/structure/shuttle/part/dropship2/transparent/left_outer_bottom_wing,
/turf/template_noop,
/area/shuttle/saigon)
"Ha" = (
/turf/closed/shuttle/saigon/transparent{
	icon_state = "97"
	},
/area/shuttle/saigon)
"HZ" = (
/obj/structure/shuttle/part/dropship2/transparent/nose_top_left,
/turf/template_noop,
/area/shuttle/saigon)
"Ic" = (
/turf/closed/shuttle/saigon{
	icon_state = "37"
	},
/area/shuttle/saigon)
"IT" = (
/turf/closed/shuttle/saigon{
	icon_state = "73"
	},
/area/shuttle/saigon)
"Kn" = (
/obj/structure/shuttle/part/dropship2/bottom_right_wall,
/turf/template_noop,
/area/shuttle/saigon)
"KE" = (
/obj/structure/shuttle/part/dropship2/transparent/right_inner_bottom_wing,
/turf/template_noop,
/area/shuttle/saigon)
"LI" = (
/turf/closed/shuttle/saigon{
	icon_state = "64"
	},
/area/shuttle/saigon)
"LL" = (
/turf/closed/shuttle/saigon{
	icon_state = "75"
	},
/area/shuttle/saigon)
"LP" = (
/obj/structure/machinery/door/airlock/hatch/cockpit/two{
	dir = 1
	},
/obj/structure/blocker/forcefield/multitile_vehicles,
/turf/open/shuttle/dropship{
	icon_state = "rasputin15"
	},
/area/shuttle/saigon)
"LW" = (
/turf/closed/shuttle/saigon/transparent{
	icon_state = "23"
	},
/area/shuttle/saigon)
"Ms" = (
/turf/closed/shuttle/saigon{
	icon_state = "69"
	},
/area/shuttle/saigon)
"Nd" = (
/obj/effect/attach_point/electronics/saigon,
/obj/structure/shuttle/part/dropship2/transparent/upper_right_wing,
/turf/template_noop,
/area/shuttle/saigon)
"Ne" = (
/obj/structure/shuttle/part/dropship2/right_outer_wing_connector,
/turf/template_noop,
/area/shuttle/saigon)
"Nx" = (
/obj/structure/platform{
	dir = 4
	},
/turf/open/shuttle/dropship{
	icon_state = "rasputin3"
	},
/area/shuttle/saigon)
"ON" = (
/turf/closed/shuttle/saigon{
	icon_state = "67"
	},
/area/shuttle/saigon)
"Qo" = (
/obj/structure/shuttle/part/dropship2/transparent/nose_top_right,
/turf/template_noop,
/area/shuttle/saigon)
"Qt" = (
/obj/effect/attach_point/crew_weapon/saigon,
/turf/open/shuttle/dropship{
	icon_state = "rasputin15"
	},
/area/shuttle/saigon)
"QA" = (
/obj/effect/attach_point/weapon/saigon/right_wing,
/obj/structure/shuttle/part/dropship2/transparent/lower_right_wing,
/turf/template_noop,
/area/shuttle/saigon)
"QE" = (
/obj/effect/attach_point/electronics/saigon,
/obj/structure/shuttle/part/dropship2/transparent/upper_left_wing,
/turf/template_noop,
/area/shuttle/saigon)
"QF" = (
/obj/structure/stairs,
/turf/open/shuttle/dropship{
	icon_state = "rasputin15"
	},
/area/shuttle/saigon)
"QU" = (
/obj/structure/transmitter/rotary{
	name = "Saigon Telephone";
	phone_category = "Dropship";
	phone_id = "Saigon";
	pixel_x = 11;
	pixel_y = 16
	},
/obj/structure/blocker/invisible_wall,
/obj/structure/machinery/computer/dropship_weapons/saigon,
/turf/open/shuttle/dropship{
	icon_state = "rasputin15"
	},
/area/shuttle/saigon)
"SF" = (
/obj/structure/blocker/forcefield/multitile_vehicles,
/obj/structure/barricade/handrail,
/turf/open/shuttle/dropship{
	icon_state = "floor8"
	},
/area/shuttle/saigon)
"TA" = (
/turf/closed/shuttle/saigon/transparent{
	icon_state = "96"
	},
/area/shuttle/saigon)
"TD" = (
/turf/closed/shuttle/saigon/transparent{
	icon_state = "27"
	},
/area/shuttle/saigon)
"TN" = (
/obj/effect/decal/warning_stripes{
	icon_state = "W"
	},
/turf/open/shuttle/dropship{
	icon_state = "rasputin15"
	},
/area/shuttle/saigon)
"TT" = (
/obj/structure/shuttle/part/dropship2/bottom_left_wall,
/turf/template_noop,
/area/shuttle/saigon)
"TV" = (
/turf/closed/shuttle/saigon/transparent{
	icon_state = "32"
	},
/area/shuttle/saigon)
"Uk" = (
/obj/structure/blocker/forcefield/multitile_vehicles,
/turf/open/shuttle/dropship{
	icon_state = "rasputin15"
	},
/area/shuttle/saigon)
"Vi" = (
/turf/closed/shuttle/saigon{
	icon_state = "31"
	},
/area/shuttle/saigon)
"VO" = (
/turf/closed/shuttle/saigon/transparent{
	icon_state = "89"
	},
/area/shuttle/saigon)
"Wp" = (
/obj/structure/machinery/door/airlock/multi_tile/almayer/dropshiprear/ds2{
	id = "aft_door";
	name = "\improper Saigon cargo door"
	},
/obj/effect/decal/warning_stripes{
	icon_state = "E";
	pixel_x = 1
	},
/turf/open/shuttle/dropship{
	icon_state = "rasputin15"
	},
/area/shuttle/saigon)
"WD" = (
/turf/closed/shuttle/saigon/transparent{
	icon_state = "26"
	},
/area/shuttle/saigon)
"Xd" = (
/obj/effect/attach_point/fuel/saigon{
	pixel_x = -32;
	dir = 1
	},
/turf/closed/shuttle/saigon/transparent{
	icon_state = "33"
	},
/area/shuttle/saigon)
"XP" = (
/turf/template_noop,
/area/template_noop)
"XW" = (
/turf/closed/shuttle/saigon{
	icon_state = "47"
	},
/area/shuttle/saigon)
"XZ" = (
/turf/closed/shuttle/saigon{
	icon_state = "76"
	},
/area/shuttle/saigon)
"Ya" = (
/turf/open/shuttle/dropship{
	icon_state = "rasputin15"
	},
/area/shuttle/saigon)
"Ym" = (
/turf/closed/shuttle/saigon{
	icon_state = "24"
	},
/area/shuttle/saigon)
"Zr" = (
/turf/closed/shuttle/saigon{
	icon_state = "36"
	},
/area/shuttle/saigon)

(1,1,1) = {"
XP
XP
XP
XP
XP
XP
XP
XP
XP
XP
XP
XP
XP
XP
XP
XP
XP
XP
XP
XP
XP
"}
(2,1,1) = {"
XP
XP
XP
XP
XP
XP
QE
ct
Bc
XP
XP
XP
XP
XP
mS
fz
fD
ee
XP
XP
ED
"}
(3,1,1) = {"
XP
XP
XP
XP
qp
LL
ru
ON
uw
Uk
ad
Zr
Zr
TT
js
AP
LW
mq
XP
XP
oI
"}
(4,1,1) = {"
XP
HZ
aK
ai
kY
XZ
af
Ch
bo
Ya
Ya
QF
bR
XW
Zr
jB
Ym
Zr
aa
Ed
ah
"}
(5,1,1) = {"
XP
is
TA
BN
Dz
se
xx
mN
mN
mN
mN
ac
mb
fw
gA
gA
gA
gA
Wp
XP
XP
"}
(6,1,1) = {"
XP
is
Ha
Af
Ya
LP
ul
bo
Ya
Qt
tj
Qt
SF
zF
Ya
Ya
Ya
Ya
Ya
XP
XP
"}
(7,1,1) = {"
XP
is
uo
QU
Dz
se
zC
mN
mN
mN
mN
mN
qP
qc
Nx
Nx
Nx
Nx
TN
XP
XP
"}
(8,1,1) = {"
XP
Qo
uF
fd
VO
XZ
ag
Ch
bo
Ya
Ya
wD
Ch
st
Ic
Vi
fT
Ic
ab
ti
Ne
"}
(9,1,1) = {"
XP
XP
XP
XP
aq
ob
IT
Ms
LI
Uk
ae
Ic
Ic
Kn
vv
TV
WD
ee
XP
XP
KE
"}
(10,1,1) = {"
XP
XP
XP
XP
XP
XP
Nd
pV
QA
XP
XP
XP
XP
XP
Cw
Xd
TD
mq
XP
XP
rB
"}
(11,1,1) = {"
XP
XP
XP
XP
XP
XP
XP
XP
XP
XP
XP
XP
XP
XP
XP
XP
XP
XP
XP
XP
XP
"}
