//MAP CONVERTED BY dmm2tgm.py THIS HEADER COMMENT PREVENTS RECONVERSION, DO NOT REMOVE
"ah" = (
/obj/structure/shuttle/part/dropship1/left_outer_wing_connector,
/turf/open/space/basic,
/area/space)
"aq" = (
/turf/closed/shuttle/dropship1{
	icon_state = "76"
	},
/area/space)
"aK" = (
/turf/closed/shuttle/dropship1{
	icon_state = "92"
	},
/area/space)
"bl" = (
/obj/effect/attach_point/electronics/dropship1{
	dir = 1
	},
/obj/structure/shuttle/part/dropship1/transparent/inner_right_weapons,
/turf/template_noop,
/area/space)
"bR" = (
/obj/structure/platform{
	dir = 8
	},
/obj/structure/stairs,
/turf/open/shuttle/dropship{
	icon_state = "rasputin15"
	},
/area/space)
"ct" = (
/turf/closed/shuttle/dropship1{
	icon_state = "62"
	},
/area/space)
"cS" = (
/obj/structure/machinery/cm_vending/sorted/medical/wall_med/vehicle{
	pixel_x = 5;
	pixel_y = -6
	},
/turf/closed/shuttle/dropship1/transparent{
	icon_state = "80"
	},
/area/space)
"cT" = (
/obj/structure/shuttle/part/dropship1/transparent/engine_left_cap,
/turf/template_noop,
/area/space)
"dA" = (
/obj/effect/attach_point/weapon/dropship1/right_wing,
/obj/structure/shuttle/part/dropship1/transparent/lower_right_wing,
/turf/template_noop,
/area/space)
"ee" = (
/obj/structure/shuttle/part/dropship1/transparent/engine_right_exhaust,
/turf/open/space/basic,
/area/space)
"el" = (
/obj/effect/decal/warning_stripes{
	icon_state = "E";
	pixel_x = 1
	},
/turf/open/shuttle/dropship{
	icon_state = "rasputin15"
	},
/area/space)
"ev" = (
/turf/closed/shuttle/dropship1/transparent{
	icon_state = "98"
	},
/area/space)
"eP" = (
/obj/structure/platform{
	dir = 8
	},
/obj/structure/platform,
/turf/open/shuttle/dropship{
	icon_state = "rasputin15"
	},
/area/space)
"fd" = (
/turf/closed/shuttle/dropship1/transparent{
	icon_state = "89"
	},
/area/space)
"fw" = (
/obj/effect/decal/warning_stripes{
	icon_state = "E";
	pixel_x = 1
	},
/turf/open/shuttle/dropship{
	icon_state = "rasputin3"
	},
/area/space)
"fx" = (
/obj/structure/shuttle/part/dropship1/lower_right_wall,
/turf/open/space/basic,
/area/space)
"fz" = (
/turf/closed/shuttle/dropship1/transparent{
	icon_state = "29"
	},
/area/space)
"fD" = (
/turf/closed/shuttle/dropship1/transparent{
	icon_state = "23"
	},
/area/space)
"ht" = (
/turf/closed/shuttle/dropship1/transparent{
	icon_state = "97"
	},
/area/space)
"is" = (
/turf/closed/shuttle/dropship1/transparent{
	icon_state = "96"
	},
/area/space)
"jj" = (
/obj/structure/platform{
	dir = 4
	},
/obj/structure/stairs,
/turf/open/shuttle/dropship{
	icon_state = "rasputin15"
	},
/area/space)
"jU" = (
/obj/structure/shuttle/part/dropship1/lower_left_wall,
/turf/open/space/basic,
/area/space)
"jZ" = (
/turf/closed/shuttle/dropship1{
	icon_state = "10"
	},
/area/space)
"kY" = (
/turf/closed/shuttle/dropship1{
	icon_state = "81"
	},
/area/space)
"kZ" = (
/turf/closed/shuttle/dropship1{
	icon_state = "75"
	},
/area/space)
"mb" = (
/obj/structure/platform{
	dir = 1;
	layer = 2.8
	},
/obj/effect/decal/warning_stripes{
	icon_state = "E";
	pixel_x = 1
	},
/turf/open/shuttle/dropship{
	icon_state = "rasputin3"
	},
/area/space)
"mN" = (
/obj/structure/blocker/forcefield/multitile_vehicles,
/turf/open/shuttle/dropship{
	icon_state = "rasputin4"
	},
/area/space)
"mS" = (
/turf/closed/shuttle/dropship1/transparent{
	icon_state = "35"
	},
/area/space)
"nM" = (
/obj/structure/shuttle/part/dropship1/transparent/nose_top_left,
/turf/template_noop,
/area/space)
"ob" = (
/turf/closed/shuttle/dropship1{
	icon_state = "14"
	},
/area/space)
"ox" = (
/obj/item/device/radio/intercom/alamo{
	pixel_x = 10
	},
/turf/closed/shuttle/dropship1{
	icon_state = "54"
	},
/area/space)
"oI" = (
/obj/structure/shuttle/part/dropship1/transparent/left_outer_bottom_wing,
/turf/template_noop,
/area/space)
"pV" = (
/turf/closed/shuttle/dropship1{
	icon_state = "64"
	},
/area/space)
"qc" = (
/obj/effect/decal/warning_stripes{
	icon_state = "W"
	},
/turf/open/shuttle/dropship{
	icon_state = "rasputin3"
	},
/area/space)
"qp" = (
/obj/structure/closet/fireaxecabinet{
	pixel_y = -10
	},
/turf/closed/shuttle/dropship1{
	icon_state = "76"
	},
/area/space)
"qN" = (
/obj/structure/shuttle/part/dropship1/transparent/middle_right_wing,
/turf/template_noop,
/area/space)
"qP" = (
/obj/structure/platform{
	dir = 1;
	layer = 2.8
	},
/obj/effect/decal/warning_stripes{
	icon_state = "W"
	},
/turf/open/shuttle/dropship{
	icon_state = "rasputin3"
	},
/area/space)
"rj" = (
/obj/structure/shuttle/part/dropship1/bottom_right_wall,
/turf/open/space/basic,
/area/space)
"rk" = (
/obj/structure/shuttle/part/dropship1/transparent/middle_left_wing,
/turf/template_noop,
/area/space)
"ru" = (
/obj/structure/bed/chair/vehicle{
	dir = 1;
	pixel_x = 8
	},
/obj/structure/bed/chair/vehicle{
	dir = 1;
	pixel_x = -8
	},
/turf/open/shuttle/dropship{
	icon_state = "rasputin15"
	},
/area/space)
"rv" = (
/obj/structure/shuttle/part/dropship1/transparent/nose_center,
/turf/template_noop,
/area/space)
"rB" = (
/obj/structure/shuttle/part/dropship1/transparent/right_outer_bottom_wing,
/turf/template_noop,
/area/space)
"rI" = (
/obj/structure/platform{
	dir = 1;
	layer = 2.8
	},
/turf/open/shuttle/dropship{
	icon_state = "rasputin15"
	},
/area/space)
"se" = (
/turf/open/shuttle/dropship{
	icon_state = "rasputin6"
	},
/area/space)
"st" = (
/obj/structure/platform{
	dir = 4
	},
/turf/open/shuttle/dropship{
	icon_state = "rasputin15"
	},
/area/space)
"sy" = (
/turf/closed/shuttle/dropship1/transparent{
	icon_state = "22"
	},
/area/space)
"sI" = (
/turf/closed/shuttle/dropship1/transparent{
	icon_state = "86"
	},
/area/space)
"ti" = (
/obj/structure/shuttle/part/dropship1/right_inner_wing_connector,
/turf/open/space/basic,
/area/space)
"tj" = (
/obj/docking_port/mobile/marine_dropship/alamo,
/obj/effect/attach_point/crew_weapon/dropship1,
/obj/effect/decal/warning_stripes,
/turf/open/shuttle/dropship{
	icon_state = "rasputin15"
	},
/area/space)
"ul" = (
/obj/effect/attach_point/crew_weapon/dropship1,
/obj/effect/decal/warning_stripes,
/turf/open/shuttle/dropship{
	icon_state = "rasputin15"
	},
/area/space)
"un" = (
/obj/structure/bed/chair/office/dark{
	dir = 8;
	layer = 3.25
	},
/obj/structure/machinery/computer/overwatch/almayer{
	dir = 8;
	pixel_x = -17;
	pixel_y = 20
	},
/obj/structure/machinery/computer/groundside_operations{
	dir = 4;
	pixel_x = -17;
	pixel_y = 6
	},
/obj/structure/machinery/computer/overwatch/almayer{
	dir = 8;
	pixel_x = -17;
	pixel_y = -10
	},
/obj/structure/platform/ship{
	dir = 4
	},
/turf/open/shuttle/dropship{
	icon_state = "rasputin15"
	},
/area/space)
"uo" = (
/obj/structure/machinery/computer/dropship_weapons/dropship1,
/obj/structure/transmitter/rotary{
	name = "Alamo Telephone";
	phone_category = "Dropship";
	phone_id = "Alamo";
	pixel_x = 11;
	pixel_y = 16
	},
/obj/structure/blocker/invisible_wall,
/turf/open/shuttle/dropship{
	icon_state = "rasputin15"
	},
/area/space)
"uC" = (
/obj/structure/shuttle/part/dropship1/bottom_left_wall,
/turf/open/space/basic,
/area/space)
"uF" = (
/turf/closed/shuttle/dropship1{
	icon_state = "94"
	},
/area/space)
"wb" = (
/obj/effect/decal/warning_stripes{
	icon_state = "S"
	},
/turf/open/shuttle/dropship{
	icon_state = "rasputin15"
	},
/area/space)
"ww" = (
/obj/structure/blocker/forcefield/multitile_vehicles,
/turf/open/shuttle/dropship{
	icon_state = "rasputin8"
	},
/area/space)
"wD" = (
/obj/effect/decal/warning_stripes{
	icon_state = "E";
	pixel_x = 1
	},
/obj/structure/blocker/forcefield/multitile_vehicles,
/turf/open/shuttle/dropship{
	icon_state = "rasputin15"
	},
/area/space)
"xx" = (
/turf/open/shuttle/dropship{
	icon_state = "rasputin3"
	},
/area/space)
"yQ" = (
/obj/structure/shuttle/part/dropship1/transparent/upper_left_wing,
/turf/template_noop,
/area/space)
"zF" = (
/obj/item/device/radio/intercom/alamo{
	pixel_y = 24
	},
/turf/open/shuttle/dropship{
	icon_state = "rasputin15"
	},
/area/space)
"Ad" = (
/obj/effect/attach_point/weapon/dropship1/left_wing,
/obj/structure/shuttle/part/dropship1/transparent/lower_left_wing,
/turf/template_noop,
/area/space)
"Af" = (
/obj/item/device/radio/intercom/alamo{
	layer = 3.5;
	pixel_x = 21;
	pixel_y = 43
	},
/turf/open/shuttle/dropship{
	icon_state = "rasputin15"
	},
/area/space)
"At" = (
/obj/effect/attach_point/weapon/dropship1/left_fore,
/obj/structure/shuttle/part/dropship1/transparent/outer_left_weapons,
/turf/template_noop,
/area/space)
"AP" = (
/turf/closed/shuttle/dropship1{
	icon_state = "30"
	},
/area/space)
"AV" = (
/obj/structure/machinery/cm_vending/sorted/cargo_guns/squad{
	req_access = null;
	req_one_access = null
	},
/turf/open/shuttle/dropship{
	icon_state = "rasputin15"
	},
/area/space)
"Bc" = (
/obj/structure/machinery/door/airlock/dropship_hatch{
	id = "port_door"
	},
/obj/structure/stairs{
	dir = 8;
	icon_state = "ramptop"
	},
/obj/structure/blocker/forcefield/multitile_vehicles,
/turf/open/shuttle/dropship{
	icon_state = "rasputin15"
	},
/area/space)
"Bf" = (
/turf/template_noop,
/area/space)
"BN" = (
/obj/structure/bed/chair/dropship/pilot{
	dir = 1
	},
/turf/open/shuttle/dropship{
	icon_state = "rasputin15"
	},
/area/space)
"BT" = (
/obj/structure/platform{
	dir = 4
	},
/obj/structure/platform,
/turf/open/shuttle/dropship{
	icon_state = "rasputin15"
	},
/area/space)
"Cw" = (
/turf/closed/shuttle/dropship1/transparent{
	icon_state = "38"
	},
/area/space)
"Dc" = (
/turf/closed/shuttle/dropship1{
	icon_state = "51"
	},
/area/space)
"Dz" = (
/obj/structure/machinery/door_control{
	id = "dropship_alamo";
	name = "Dropship Lockdown";
	normaldoorcontrol = 3;
	pixel_y = -19;
	req_one_access_txt = "3;22";
	throw_range = 15
	},
/turf/closed/shuttle/dropship1/transparent{
	icon_state = "78"
	},
/area/space)
"Ed" = (
/obj/structure/shuttle/part/dropship1/left_inner_wing_connector,
/turf/open/space/basic,
/area/space)
"ED" = (
/obj/structure/shuttle/part/dropship1/transparent/left_inner_bottom_wing,
/turf/template_noop,
/area/space)
"Fv" = (
/turf/closed/shuttle/dropship1/transparent{
	icon_state = "34"
	},
/area/space)
"Ha" = (
/obj/structure/blocker/invisible_wall,
/obj/structure/machinery/computer/shuttle/dropship/flight,
/turf/open/shuttle/dropship{
	icon_state = "rasputin15"
	},
/area/space)
"HZ" = (
/obj/structure/shuttle/part/dropship1/nose_front_left,
/turf/template_noop,
/area/space)
"Ic" = (
/obj/structure/machinery/cm_vending/sorted/cargo_guns/squad_prep{
	req_access = null;
	req_one_access = null
	},
/turf/open/shuttle/dropship{
	icon_state = "rasputin15"
	},
/area/space)
"Ij" = (
/turf/closed/shuttle/dropship1/transparent{
	icon_state = "39"
	},
/area/space)
"Iq" = (
/turf/closed/shuttle/dropship1{
	icon_state = "50"
	},
/area/space)
"Iz" = (
/obj/effect/attach_point/fuel/dropship1,
/turf/closed/shuttle/dropship1/transparent{
	icon_state = "28"
	},
/area/space)
"IT" = (
/obj/structure/machinery/camera/autoname/almayer/dropship_one{
	dir = 8;
	pixel_x = 16
	},
/obj/structure/bed/chair/vehicle{
	dir = 1;
	pixel_x = 8
	},
/obj/structure/bed/chair/vehicle{
	dir = 1;
	pixel_x = -8
	},
/turf/open/shuttle/dropship{
	icon_state = "rasputin15"
	},
/area/space)
"Jk" = (
/obj/structure/shuttle/part/dropship1/transparent/engine_right_cap,
/turf/template_noop,
/area/space)
"Kg" = (
/obj/structure/machinery/door/airlock/hatch/cockpit,
/obj/structure/blocker/forcefield/multitile_vehicles,
/turf/open/shuttle/dropship{
	icon_state = "rasputin15"
	},
/area/space)
"Kn" = (
/turf/closed/shuttle/dropship1{
	icon_state = "43"
	},
/area/space)
"Kz" = (
/obj/structure/blocker/forcefield/multitile_vehicles,
/turf/open/shuttle/dropship{
	icon_state = "rasputin5"
	},
/area/space)
"KE" = (
/obj/structure/shuttle/part/dropship1/transparent/right_inner_bottom_wing,
/turf/template_noop,
/area/space)
"KO" = (
/turf/closed/shuttle/dropship1/transparent{
	icon_state = "27"
	},
/area/space)
"Li" = (
/obj/structure/shuttle/part/dropship1/transparent/engine_left_exhaust,
/turf/open/space/basic,
/area/space)
"Lp" = (
/turf/closed/shuttle/dropship1{
	icon_state = "72"
	},
/area/space)
"LL" = (
/obj/structure/bed/chair/vehicle{
	pixel_x = -8
	},
/obj/structure/bed/chair/vehicle{
	pixel_x = 8
	},
/turf/open/shuttle/dropship{
	icon_state = "rasputin15"
	},
/area/space)
"LP" = (
/turf/open/shuttle/dropship{
	icon_state = "floor8"
	},
/area/space)
"LW" = (
/turf/closed/shuttle/dropship1{
	icon_state = "24"
	},
/area/space)
"Nd" = (
/turf/closed/shuttle/dropship1{
	icon_state = "69"
	},
/area/space)
"Ne" = (
/obj/structure/shuttle/part/dropship1/right_outer_wing_connector,
/turf/open/space/basic,
/area/space)
"Pg" = (
/obj/effect/attach_point/weapon/dropship1/right_fore,
/obj/structure/shuttle/part/dropship1/transparent/outer_right_weapons,
/turf/template_noop,
/area/space)
"PZ" = (
/obj/effect/attach_point/electronics/dropship1{
	dir = 1
	},
/obj/structure/shuttle/part/dropship1/transparent/inner_left_weapons,
/turf/template_noop,
/area/space)
"Qo" = (
/obj/structure/shuttle/part/dropship1/nose_front_right,
/turf/template_noop,
/area/space)
"Qr" = (
/turf/closed/shuttle/dropship1{
	icon_state = "73"
	},
/area/space)
"Qt" = (
/turf/open/shuttle/dropship{
	icon_state = "rasputin15"
	},
/area/space)
"Qx" = (
/obj/structure/stairs,
/obj/structure/platform/ship{
	dir = 4
	},
/turf/open/shuttle/dropship{
	icon_state = "rasputin15"
	},
/area/space)
"QA" = (
/obj/structure/machinery/door/airlock/dropship_hatch{
	dir = 8;
	id = "starboard_door"
	},
/obj/structure/stairs{
	dir = 4
	},
/obj/structure/blocker/forcefield/multitile_vehicles,
/turf/open/shuttle/dropship{
	icon_state = "rasputin15"
	},
/area/space)
"QE" = (
/turf/closed/shuttle/dropship1{
	icon_state = "67"
	},
/area/space)
"QF" = (
/obj/structure/blocker/forcefield/multitile_vehicles,
/turf/open/shuttle/dropship{
	icon_state = "rasputin15"
	},
/area/space)
"QU" = (
/obj/structure/bed/chair/dropship/pilot{
	dir = 1
	},
/obj/structure/machinery/camera/autoname/almayer/dropship_one{
	pixel_x = -6;
	pixel_y = -16
	},
/turf/open/shuttle/dropship{
	icon_state = "rasputin15"
	},
/area/space)
"RC" = (
/turf/open/shuttle/dropship{
	icon_state = "rasputin7"
	},
/area/space)
"TA" = (
/obj/structure/prop/ice_colony/hula_girl{
	pixel_x = -10;
	pixel_y = 16
	},
/obj/structure/blocker/invisible_wall,
/obj/structure/machinery/computer/cameras/dropship/one,
/turf/open/shuttle/dropship{
	icon_state = "rasputin15"
	},
/area/space)
"TD" = (
/turf/closed/shuttle/dropship1/transparent{
	icon_state = "26"
	},
/area/space)
"TN" = (
/obj/effect/decal/warning_stripes{
	icon_state = "W"
	},
/turf/open/shuttle/dropship{
	icon_state = "rasputin15"
	},
/area/space)
"TT" = (
/turf/closed/shuttle/dropship1{
	icon_state = "42"
	},
/area/space)
"TV" = (
/turf/closed/shuttle/dropship1{
	icon_state = "31"
	},
/area/space)
"UU" = (
/obj/structure/shuttle/part/dropship1/transparent/nose_top_right,
/turf/template_noop,
/area/space)
"Va" = (
/obj/structure/shuttle/part/dropship1/transparent/upper_right_wing,
/turf/template_noop,
/area/space)
"VO" = (
/obj/structure/extinguisher_cabinet/alt{
	pixel_x = -14;
	pixel_y = -9
	},
/turf/closed/shuttle/dropship1{
	icon_state = "77"
	},
/area/space)
"We" = (
/obj/effect/attach_point/fuel/dropship1{
	pixel_x = -32
	},
/turf/closed/shuttle/dropship1/transparent{
	icon_state = "33"
	},
/area/space)
"Wp" = (
/obj/structure/machinery/door/airlock/multi_tile/almayer/dropshiprear/ds1{
	id = "aft_door"
	},
/obj/effect/decal/warning_stripes{
	icon_state = "E";
	pixel_x = 1
	},
/turf/open/shuttle/dropship{
	icon_state = "rasputin15"
	},
/area/space)
"WD" = (
/turf/closed/shuttle/dropship1{
	icon_state = "25"
	},
/area/space)
"Xd" = (
/turf/closed/shuttle/dropship1/transparent{
	icon_state = "32"
	},
/area/space)
"Xj" = (
/turf/closed/shuttle/dropship1{
	icon_state = "83"
	},
/area/space)
"XP" = (
/obj/item/device/radio/intercom/alamo{
	pixel_x = -10
	},
/turf/closed/shuttle/dropship1{
	icon_state = "52"
	},
/area/space)
"XW" = (
/obj/structure/platform{
	dir = 8
	},
/turf/open/shuttle/dropship{
	icon_state = "rasputin15"
	},
/area/space)
"XZ" = (
/obj/structure/bed/chair/vehicle{
	pixel_x = -8
	},
/obj/structure/bed/chair/vehicle{
	pixel_x = 8
	},
/obj/item/device/radio/intercom/alamo{
	pixel_y = 24
	},
/turf/open/shuttle/dropship{
	icon_state = "rasputin15"
	},
/area/space)
"Ya" = (
/obj/effect/decal/warning_stripes{
	icon_state = "SE-out";
	pixel_x = 1
	},
/turf/open/shuttle/dropship{
	icon_state = "rasputin15"
	},
/area/space)
"Zr" = (
/obj/structure/machinery/camera/autoname/almayer/dropship_one{
	dir = 4;
	pixel_x = -16
	},
/obj/structure/platform{
	dir = 8
	},
/turf/open/shuttle/dropship{
	icon_state = "rasputin15"
	},
/area/space)

(1,1,1) = {"
Bf
Bf
Bf
Bf
Bf
yQ
rk
Ad
Bf
Bf
Bf
Bf
Bf
cT
Fv
Iz
sy
Li
Bf
Bf
Bf
"}
(2,1,1) = {"
Bf
Bf
Bf
At
kZ
Lp
QE
ct
Bc
Bc
XP
Iq
jU
Jk
mS
fz
fD
ee
Bf
Bf
ED
"}
(3,1,1) = {"
Bf
Bf
Bf
PZ
qp
LL
ru
LL
Qt
Qt
Qx
un
jZ
TT
TT
AP
LW
TT
uC
Bf
oI
"}
(4,1,1) = {"
nM
HZ
aK
sI
kY
XZ
ru
LL
Qt
Qt
Qt
QF
bR
XW
Zr
XW
XW
eP
jZ
Ed
ah
"}
(5,1,1) = {"
rv
is
TA
BN
Dz
se
xx
xx
xx
xx
xx
mN
mb
fw
fw
fw
fw
fw
Wp
Bf
Bf
"}
(6,1,1) = {"
rv
ht
Ha
Af
Kg
LP
ul
Qt
ul
Qt
tj
Kz
rI
zF
Qt
Qt
Qt
Qt
Qt
Bf
Bf
"}
(7,1,1) = {"
rv
ev
uo
QU
cS
RC
xx
xx
xx
xx
xx
ww
qP
qc
qc
qc
qc
qc
TN
Bf
Bf
"}
(8,1,1) = {"
UU
Qo
uF
fd
VO
XZ
ru
LL
Qt
Ya
el
wD
jj
st
st
st
st
BT
ob
ti
Ne
"}
(9,1,1) = {"
Bf
Bf
Bf
bl
aq
LL
IT
LL
Qt
wb
AV
Ic
jZ
Kn
Kn
TV
WD
Kn
rj
Bf
KE
"}
(10,1,1) = {"
Bf
Bf
Bf
Pg
Xj
Qr
Nd
pV
QA
QA
ox
Dc
fx
cT
Cw
Xd
TD
Li
Bf
Bf
rB
"}
(11,1,1) = {"
Bf
Bf
Bf
Bf
Bf
Va
qN
dA
Bf
Bf
Bf
Bf
Bf
Jk
Ij
We
KO
ee
Bf
Bf
Bf
"}
