//MAP CONVERTED BY dmm2tgm.py THIS HEADER COMMENT PREVENTS RECONVERSION, DO NOT REMOVE
"a" = (
/obj/effect/decal/warning_stripes{
	icon_state = "SE-out"
	},
/turf/open/floor/plating/plating_catwalk,
/area/shuttle/vehicle_elevator)
"b" = (
/obj/effect/decal/warning_stripes{
	icon_state = "S"
	},
/turf/open/floor/plating/plating_catwalk,
/area/shuttle/vehicle_elevator)
"c" = (
/obj/effect/decal/warning_stripes{
	icon_state = "SW-out"
	},
/obj/structure/machinery/computer/supply/asrs/vehicle{
	pixel_y = 16;
	density = 0;
	can_block_movement = 0
	},
/turf/open/floor/plating/plating_catwalk,
/area/shuttle/vehicle_elevator)
"d" = (
/obj/effect/decal/warning_stripes{
	icon_state = "E"
	},
/turf/open/floor/plating/plating_catwalk,
/area/shuttle/vehicle_elevator)
"e" = (
/turf/open/floor/almayer/plate,
/area/shuttle/vehicle_elevator)
"f" = (
/obj/effect/decal/warning_stripes{
	icon_state = "W"
	},
/turf/open/floor/plating/plating_catwalk,
/area/shuttle/vehicle_elevator)
"g" = (
/obj/docking_port/mobile/vehicle_elevator,
/turf/open/floor/plating/plating_catwalk,
/area/shuttle/vehicle_elevator)
"h" = (
/obj/effect/decal/warning_stripes{
	icon_state = "NE-out"
	},
/turf/open/floor/plating/plating_catwalk,
/area/shuttle/vehicle_elevator)
"i" = (
/obj/effect/decal/warning_stripes{
	icon_state = "N"
	},
/turf/open/floor/plating/plating_catwalk,
/area/shuttle/vehicle_elevator)
"j" = (
/obj/effect/decal/warning_stripes{
	icon_state = "NW-out"
	},
/turf/open/floor/plating/plating_catwalk,
/area/shuttle/vehicle_elevator)
"k" = (
/obj/effect/decal/warning_stripes{
	icon_state = "S"
	},
/obj/structure/machinery/door_control{
	pixel_x = -8;
	id = "BG Vehicle Under";
	req_one_access = list(1,19);
	name = "\improper Lower Railing Control";
	pixel_y = 22
	},
/obj/structure/machinery/door_control/railings{
	id = "BG Vehicle Railing";
	pixel_x = 8;
	req_one_access = list(19,21);
	pixel_y = 22;
	name = "\improper Upper Railing Control"
	},
/turf/open/floor/plating/plating_catwalk,
/area/shuttle/vehicle_elevator)

(1,1,1) = {"
a
d
d
d
h
"}
(2,1,1) = {"
b
e
e
e
i
"}
(3,1,1) = {"
k
e
g
e
i
"}
(4,1,1) = {"
b
e
e
e
i
"}
(5,1,1) = {"
c
f
f
f
j
"}
