//MAP CONVERTED BY dmm2tgm.py THIS HEADER COMMENT PREVENTS RECONVERSION, DO NOT REMOVE
"a" = (
/turf/open/floor/almayer{
	icon_state = "test_floor5"
	},
/area/interior/vehicle/van)
"c" = (
/obj/structure/interior_wall/van{
	icon_state = "back_2"
	},
/turf/open/void/vehicle,
/area/space)
"e" = (
/obj/structure/bed/chair/comfy{
	dir = 4
	},
/obj/effect/landmark/interior/spawn/entrance{
	alpha = 50;
	exit_type = /obj/structure/interior_exit/vehicle/jeep/right;
	name = "right entrance marker";
	tag = "right"
	},
/turf/open/shuttle/vehicle/floor_3_5,
/area/interior/vehicle/van)
"h" = (
/obj/structure/interior_wall/van{
	icon_state = "jeep_6"
	},
/turf/open/void/vehicle,
/area/space)
"k" = (
/obj/effect/vehicle_roof/van{
	icon_state = "front_roof_2";
	alpha = 50
	},
/obj/effect/landmark/interior/spawn/weapons_loader_skilless{
	pixel_y = 3;
	pixel_x = 14
	},
/turf/open/shuttle/vehicle/floor_1_14,
/area/interior/vehicle/van)
"l" = (
/obj/structure/interior_wall/van{
	icon_state = "interior_door"
	},
/obj/effect/vehicle_roof/van{
	icon_state = "front_roof_1";
	alpha = 50
	},
/turf/open/void/vehicle,
/area/space)
"m" = (
/obj/structure/interior_wall/van{
	icon_state = "front_3"
	},
/turf/open/void/vehicle,
/area/space)
"o" = (
/obj/structure/interior_wall/van{
	icon_state = "front_1"
	},
/turf/open/void/vehicle,
/area/space)
"p" = (
/obj/structure/interior_wall/van{
	alpha = 35;
	icon_state = "jeep_2";
	layer = 5.2;
	pixel_y = 32
	},
/turf/open/void/vehicle,
/area/space)
"r" = (
/obj/structure/interior_wall/van{
	icon_state = "back_1"
	},
/turf/open/void/vehicle,
/area/space)
"z" = (
/obj/structure/bed/chair/comfy{
	dir = 4
	},
/obj/effect/landmark/interior/spawn/entrance{
	alpha = 50;
	exit_type = /obj/structure/interior_exit/vehicle/jeep/right_rear;
	name = "right entrance marker";
	tag = "right_rear"
	},
/turf/open/shuttle/vehicle/floor_3_5,
/area/interior/vehicle/van)
"A" = (
/turf/open/shuttle/vehicle/floor_1_5,
/area/interior/vehicle/van)
"E" = (
/obj/structure/bed/chair/comfy{
	dir = 4
	},
/obj/effect/landmark/interior/spawn/entrance{
	dir = 1;
	exit_type = /obj/structure/interior_exit/vehicle/jeep/left_rear;
	name = "left entrance marker";
	pixel_y = 32;
	tag = "left_rear"
	},
/turf/open/shuttle/vehicle/floor_3_5,
/area/interior/vehicle/van)
"H" = (
/obj/structure/interior_wall/van{
	icon_state = "front_2"
	},
/turf/open/void/vehicle,
/area/space)
"I" = (
/obj/structure/interior_wall/van{
	icon_state = "jeep_5";
	pixel_y = 32;
	alpha = 35
	},
/turf/open/void/vehicle,
/area/space)
"K" = (
/turf/open/void/vehicle,
/area/space)
"L" = (
/obj/structure/interior_wall/van{
	icon_state = "back_3"
	},
/turf/open/void/vehicle,
/area/space)
"O" = (
/obj/structure/interior_wall/van{
	alpha = 35;
	icon_state = "exterior_door";
	layer = 5.2;
	pixel_y = 32
	},
/turf/open/void/vehicle,
/area/space)
"P" = (
/obj/structure/interior_wall/van{
	icon_state = "jeep_2"
	},
/turf/open/void/vehicle,
/area/space)
"Q" = (
/obj/effect/landmark/interior/spawn/vehicle_gunner_seat/untrained{
	dir = 4
	},
/turf/open/shuttle/vehicle/floor_1_13,
/area/interior/vehicle/van)
"T" = (
/obj/effect/landmark/interior/spawn/vehicle_driver_seat{
	dir = 4
	},
/obj/effect/vehicle_roof/van{
	icon_state = "front_roof_2";
	alpha = 50
	},
/obj/effect/landmark/interior/spawn/entrance{
	dir = 1;
	exit_type = /obj/structure/interior_exit/vehicle/jeep/left;
	name = "left entrance marker";
	pixel_y = 32;
	tag = "left"
	},
/turf/open/shuttle/vehicle/floor_3_5,
/area/interior/vehicle/van)
"Y" = (
/obj/structure/extinguisher_cabinet/lifeboat{
	icon = 'icons/obj/vehicles/interiors/general.dmi';
	layer = 3.5;
	pixel_y = 28;
	pixel_x = -6
	},
/obj/structure/machinery/cm_vending/sorted/medical/wall_med/vehicle{
	layer = 3.98;
	pixel_x = 7;
	pixel_y = 28
	},
/turf/open/floor/almayer{
	icon_state = "test_floor5"
	},
/area/interior/vehicle/van)

(1,1,1) = {"
K
L
c
c
r
K
"}
(2,1,1) = {"
K
h
Y
Q
a
I
"}
(3,1,1) = {"
K
P
E
A
z
p
"}
(4,1,1) = {"
K
l
T
k
e
O
"}
(5,1,1) = {"
K
m
H
H
o
K
"}
