//MAP CONVERTED BY dmm2tgm.py THIS HEADER COMMENT PREVENTS RECONVERSION, DO NOT REMOVE
"a" = (
/turf/open/void/vehicle,
/area/space)
"b" = (
/obj/structure/bed/chair/comfy/blue,
/turf/open/shuttle/vehicle/floor_1_5,
/area/interior/vehicle/van)
"c" = (
/obj/structure/interior_wall/van{
	icon_state = "jeep_5";
	pixel_y = 32;
	alpha = 35
	},
/turf/open/void/vehicle,
/area/space)
"d" = (
/obj/structure/interior_wall/van{
	icon_state = "jeep_4";
	pixel_y = 32;
	alpha = 35
	},
/turf/open/void/vehicle,
/area/space)
"e" = (
/obj/structure/interior_wall/van{
	alpha = 35;
	icon_state = "exterior_door";
	layer = 5.2;
	pixel_y = 32
	},
/turf/open/void/vehicle,
/area/space)
"k" = (
/obj/structure/surface/table/reinforced/almayer_B,
/obj/structure/machinery/computer/crew/alt{
	dir = 1;
	pixel_x = -4;
	pixel_y = -3
	},
/turf/open/shuttle/vehicle/floor_3_5,
/area/interior/vehicle/van)
"l" = (
/obj/effect/landmark/interior/spawn/vehicle_driver_seat{
	dir = 4
	},
/obj/effect/vehicle_roof/van{
	icon_state = "front_roof_2";
	alpha = 50
	},
/obj/effect/landmark/interior/spawn/entrance{
	dir = 1;
	exit_type = /obj/structure/interior_exit/vehicle/jeep/left;
	name = "left entrance marker";
	pixel_y = 32;
	tag = "left"
	},
/turf/open/shuttle/vehicle/floor_3_5,
/area/interior/vehicle/van)
"m" = (
/obj/effect/landmark/interior/spawn/telephone{
	pixel_x = -5;
	pixel_y = 28;
	layer = 3.5
	},
/turf/open/shuttle/vehicle/floor_3_5,
/area/interior/vehicle/van)
"n" = (
/obj/structure/interior_wall/van{
	icon_state = "front_1"
	},
/turf/open/void/vehicle,
/area/space)
"p" = (
/turf/open/shuttle/vehicle/floor_3_5,
/area/interior/vehicle/van)
"q" = (
/turf/open/shuttle/vehicle/floor_1_5,
/area/interior/vehicle/van)
"r" = (
/obj/structure/bed/chair/comfy{
	dir = 4
	},
/obj/effect/landmark/interior/spawn/entrance{
	alpha = 50;
	exit_type = /obj/structure/interior_exit/vehicle/jeep/right;
	name = "right entrance marker";
	tag = "right"
	},
/turf/open/shuttle/vehicle/floor_3_5,
/area/interior/vehicle/van)
"s" = (
/obj/structure/interior_wall/van{
	icon_state = "front_3"
	},
/turf/open/void/vehicle,
/area/space)
"t" = (
/obj/structure/interior_wall/van{
	icon_state = "interior_door"
	},
/obj/effect/vehicle_roof/van{
	icon_state = "front_roof_1";
	alpha = 50
	},
/turf/open/void/vehicle,
/area/space)
"u" = (
/obj/structure/interior_wall/van{
	icon_state = "jeep_7"
	},
/turf/open/void/vehicle,
/area/space)
"y" = (
/obj/effect/landmark/interior/spawn/weapons_loader{
	pixel_y = 3;
	pixel_x = 14
	},
/obj/effect/vehicle_roof/van{
	icon_state = "front_roof_2";
	alpha = 50
	},
/turf/open/shuttle/vehicle/floor_1_14,
/area/interior/vehicle/van)
"A" = (
/obj/structure/interior_wall/van{
	icon_state = "back_2"
	},
/turf/open/void/vehicle,
/area/space)
"C" = (
/obj/structure/interior_wall/van{
	icon_state = "back_1"
	},
/turf/open/void/vehicle,
/area/space)
"H" = (
/obj/effect/landmark/interior/spawn/entrance{
	alpha = 50;
	exit_type = /obj/structure/interior_exit/vehicle/jeep/rear;
	name = "rear entrance marker";
	tag = "rear";
	dir = 8;
	pixel_x = -32
	},
/turf/open/shuttle/vehicle/floor_1_13,
/area/interior/vehicle/van)
"K" = (
/obj/structure/machinery/computer/squad_changer{
	pixel_x = -6;
	pixel_y = 18;
	layer = 3.3
	},
/obj/structure/bed/chair/comfy/blue{
	dir = 1
	},
/obj/structure/machinery/computer/groundside_operations/arc{
	pixel_x = 12;
	pixel_y = 18;
	layer = 3.5
	},
/turf/open/floor/almayer{
	icon_state = "test_floor5"
	},
/area/interior/vehicle/van)
"P" = (
/obj/structure/interior_wall/van{
	icon_state = "jeep_6"
	},
/turf/open/void/vehicle,
/area/space)
"Q" = (
/obj/structure/machinery/cm_vending/sorted/medical/wall_med/vehicle{
	layer = 3.98;
	pixel_x = 8;
	pixel_y = 28
	},
/obj/structure/extinguisher_cabinet/lifeboat{
	icon = 'icons/obj/vehicles/interiors/general.dmi';
	layer = 3.5;
	pixel_y = 28;
	pixel_x = -5
	},
/turf/open/shuttle/vehicle/floor_3_5,
/area/interior/vehicle/van)
"S" = (
/obj/structure/interior_wall/van{
	icon_state = "back_3"
	},
/turf/open/void/vehicle,
/area/space)
"U" = (
/obj/structure/interior_wall/van{
	icon_state = "front_2"
	},
/turf/open/void/vehicle,
/area/space)
"W" = (
/obj/structure/surface/table/reinforced/almayer_B,
/obj/item/paper_bin/wy{
	pixel_x = -20;
	pixel_y = 5
	},
/obj/item/tool/pen{
	pixel_x = -21;
	pixel_y = 1
	},
/obj/structure/machinery/faxmachine/uscm/blackgold/command{
	sub_name = "CIC";
	pixel_x = 1;
	pixel_y = 1
	},
/turf/open/shuttle/vehicle/floor_3_5,
/area/interior/vehicle/van)

(1,1,1) = {"
a
S
A
A
C
a
"}
(2,1,1) = {"
a
P
K
H
k
c
"}
(3,1,1) = {"
a
u
m
b
W
d
"}
(4,1,1) = {"
a
u
Q
q
p
d
"}
(5,1,1) = {"
a
t
l
y
r
e
"}
(6,1,1) = {"
a
s
U
U
n
a
"}
