//MAP CONVERTED BY dmm2tgm.py THIS HEADER COMMENT PREVENTS RECONVERSION, DO NOT REMOVE
"a" = (
/turf/open/void/vehicle,
/area/space)
"e" = (
/obj/structure/interior_wall/van{
	alpha = 35;
	icon_state = "exterior_door";
	layer = 5.2;
	pixel_y = 32
	},
/turf/open/void/vehicle,
/area/space)
"j" = (
/obj/structure/interior_wall/van{
	alpha = 35;
	icon_state = "jeep_2";
	layer = 5.2;
	pixel_y = 32
	},
/turf/open/void/vehicle,
/area/space)
"k" = (
/turf/open/floor/almayer{
	icon_state = "test_floor5"
	},
/area/interior/vehicle/van)
"l" = (
/obj/effect/landmark/interior/spawn/vehicle_driver_seat{
	dir = 4
	},
/obj/effect/landmark/interior/spawn/entrance{
	dir = 1;
	exit_type = /obj/structure/interior_exit/vehicle/van/left;
	name = "left entrance marker";
	pixel_y = 32;
	tag = "left"
	},
/obj/effect/vehicle_roof/van{
	icon_state = "front_roof_2";
	alpha = 50
	},
/turf/open/shuttle/vehicle/floor_3_1_1,
/area/interior/vehicle/van)
"m" = (
/obj/structure/extinguisher_cabinet/lifeboat{
	icon = 'icons/obj/vehicles/interiors/general.dmi';
	layer = 3.5;
	pixel_y = 28;
	pixel_x = -5
	},
/obj/structure/machinery/cm_vending/sorted/medical/wall_med/vehicle{
	layer = 3.98;
	pixel_x = 8;
	pixel_y = 28
	},
/turf/open/floor/almayer{
	icon_state = "test_floor5"
	},
/area/interior/vehicle/van)
"n" = (
/obj/structure/interior_wall/van{
	icon_state = "front_1"
	},
/turf/open/void/vehicle,
/area/space)
"o" = (
/obj/structure/interior_wall/van{
	icon_state = "jeep_5";
	pixel_y = 32;
	alpha = 35
	},
/turf/open/void/vehicle,
/area/space)
"p" = (
/obj/structure/bed/chair/comfy{
	dir = 4
	},
/turf/open/shuttle/vehicle/floor_3_5,
/area/interior/vehicle/van)
"q" = (
/turf/open/shuttle/vehicle/floor_1_5,
/area/interior/vehicle/van)
"r" = (
/obj/structure/bed/chair/comfy{
	dir = 4
	},
/obj/effect/landmark/interior/spawn/entrance{
	alpha = 50;
	exit_type = /obj/structure/interior_exit/vehicle/van/right;
	name = "right entrance marker";
	tag = "right"
	},
/turf/open/shuttle/vehicle/floor_3_5,
/area/interior/vehicle/van)
"s" = (
/obj/structure/interior_wall/van{
	icon_state = "front_3"
	},
/turf/open/void/vehicle,
/area/space)
"t" = (
/obj/structure/interior_wall/van{
	icon_state = "interior_door"
	},
/obj/effect/vehicle_roof/van{
	icon_state = "front_roof_1";
	alpha = 50
	},
/turf/open/space/basic,
/area/space)
"u" = (
/obj/structure/interior_wall/van{
	icon_state = "jeep_7"
	},
/turf/open/void/vehicle,
/area/space)
"y" = (
/obj/effect/landmark/interior/spawn/entrance{
	dir = 1;
	exit_type = /obj/structure/interior_exit/vehicle/van/left;
	name = "left entrance marker";
	pixel_y = 32;
	tag = "left"
	},
/obj/effect/landmark/interior/spawn/weapons_loader{
	pixel_y = 3;
	pixel_x = 14
	},
/obj/effect/vehicle_roof/van{
	icon_state = "front_roof_2";
	alpha = 50
	},
/turf/open/shuttle/vehicle/floor_1_14,
/area/interior/vehicle/van)
"A" = (
/obj/structure/interior_wall/van{
	icon_state = "back_2"
	},
/turf/open/void/vehicle,
/area/space)
"C" = (
/obj/structure/interior_wall/van{
	icon_state = "back_1"
	},
/turf/open/void/vehicle,
/area/space)
"F" = (
/obj/structure/interior_wall/van{
	icon_state = "jeep_2"
	},
/turf/open/void/vehicle,
/area/space)
"H" = (
/turf/open/shuttle/vehicle/floor_1_13,
/area/interior/vehicle/van)
"K" = (
/obj/structure/machinery/computer/groundside_operations{
	indestructible = 1;
	layer = 3.3;
	pixel_x = 12;
	pixel_y = 18
	},
/obj/structure/machinery/computer/squad_changer{
	pixel_x = -6;
	pixel_y = 18;
	layer = 3.3
	},
/obj/structure/bed/chair/comfy{
	dir = 1
	},
/turf/open/floor/almayer{
	icon_state = "test_floor5"
	},
/area/interior/vehicle/van)
"P" = (
/obj/structure/interior_wall/van{
	icon_state = "jeep_6"
	},
/turf/open/space/basic,
/area/space)
"Q" = (
/obj/structure/bed/chair/comfy{
	dir = 4
	},
/turf/open/shuttle/vehicle/floor_3_1_1,
/area/interior/vehicle/van)
"S" = (
/obj/structure/interior_wall/van{
	icon_state = "back_3"
	},
/turf/open/void/vehicle,
/area/space)
"U" = (
/obj/structure/interior_wall/van{
	icon_state = "front_2"
	},
/turf/open/void/vehicle,
/area/space)
"W" = (
/obj/effect/landmark/interior/spawn/telephone{
	pixel_x = 8;
	pixel_y = -18;
	dir = 1
	},
/turf/open/floor/almayer{
	icon_state = "test_floor5"
	},
/area/interior/vehicle/van)
"Y" = (
/obj/structure/interior_wall/van{
	icon_state = "jeep_4";
	pixel_y = 32;
	alpha = 35
	},
/turf/open/void/vehicle,
/area/space)

(1,1,1) = {"
a
S
A
A
C
a
"}
(2,1,1) = {"
a
P
K
H
k
o
"}
(3,1,1) = {"
a
u
m
q
W
Y
"}
(4,1,1) = {"
a
F
Q
q
p
j
"}
(5,1,1) = {"
a
t
l
y
r
e
"}
(6,1,1) = {"
a
s
U
U
n
a
"}
