//MAP CONVERTED BY dmm2tgm.py THIS HEADER COMMENT PREVENTS RECONVERSION, DO NOT REMOVE
"a" = (
/obj/structure/bed/chair/vehicle{
	dir = 1;
	pixel_x = -8
	},
/obj/structure/bed/chair/vehicle{
	dir = 1;
	pixel_x = 8
	},
/obj/effect/landmark/interior/spawn/interior_viewport{
	dir = 1;
	pixel_y = -11
	},
/turf/open/shuttle/vehicle/floor_3_5,
/area/interior/vehicle/lav)
"b" = (
/obj/structure/bed/chair/vehicle{
	dir = 1;
	pixel_x = -8
	},
/obj/structure/bed/chair/vehicle{
	dir = 1;
	pixel_x = 8
	},
/obj/effect/landmark/interior/spawn/entrance{
	dir = 8;
	exit_type = /obj/structure/interior_exit/vehicle/lav/rear/right;
	pixel_x = -32;
	tag = "rear right"
	},
/turf/open/shuttle/vehicle/floor_3_13,
/area/interior/vehicle/lav)
"c" = (
/obj/structure/interior_wall/apc{
	icon_state = "rear_3";
	name = "\improper LAV interior wall"
	},
/turf/open/void/vehicle,
/area/space)
"d" = (
/obj/structure/interior_wall/apc{
	icon_state = "rear_4";
	name = "\improper LAV interior wall"
	},
/turf/open/void/vehicle,
/area/space)
"e" = (
/obj/structure/vehicle_locker{
	layer = 5.21;
	pixel_y = 28
	},
/turf/open/shuttle/vehicle/floor_3_5,
/area/interior/vehicle/lav)
"h" = (
/obj/structure/interior_wall/apc{
	icon_state = "lav_wheel";
	opacity = 0;
	name = "\improper LAV interior wall"
	},
/turf/open/void/vehicle,
/area/space)
"j" = (
/obj/effect/landmark/interior/spawn/entrance{
	dir = 8;
	exit_type = /obj/structure/interior_exit/vehicle/lav/rear;
	pixel_x = -32;
	tag = "rear center"
	},
/turf/open/shuttle/vehicle/floor_1_5,
/area/interior/vehicle/lav)
"k" = (
/turf/open/shuttle/vehicle/floor_1_5,
/area/interior/vehicle/lav)
"n" = (
/obj/structure/interior_wall/apc{
	icon_state = "front_2";
	name = "\improper LAV interior wall"
	},
/turf/open/void/vehicle,
/area/space)
"r" = (
/obj/structure/interior_wall/apc{
	icon_state = "rear_6";
	name = "\improper LAV interior wall"
	},
/turf/open/void/vehicle,
/area/space)
"t" = (
/obj/effect/landmark/interior/spawn/interior_camera{
	dir = 6;
	pixel_x = 16;
	pixel_y = 10
	},
/obj/effect/landmark/interior/spawn/vehicle_gunner_seat/armor{
	dir = 4
	},
/turf/open/shuttle/vehicle/floor_1_5,
/area/interior/vehicle/lav)
"u" = (
/obj/structure/interior_wall/apc{
	icon_state = "wall_2";
	opacity = 0;
	name = "\improper LAV interior wall"
	},
/turf/open/void/vehicle,
/area/space)
"v" = (
/obj/structure/bed/chair/vehicle{
	dir = 1;
	pixel_x = -8
	},
/turf/open/shuttle/vehicle/floor_3_5,
/area/interior/vehicle/lav)
"w" = (
/obj/structure/interior_wall/apc{
	icon_state = "front_8";
	pixel_x = 3;
	name = "\improper LAV interior wall"
	},
/turf/open/shuttle/vehicle/floor_3_5,
/area/space)
"y" = (
/obj/structure/interior_wall/apc{
	icon_state = "rear_2";
	name = "\improper LAV interior wall"
	},
/turf/open/void/vehicle,
/area/space)
"B" = (
/obj/effect/landmark/interior/spawn/telephone{
	pixel_x = 8;
	pixel_y = 31
	},
/obj/structure/machinery/prop/almayer/CICmap/computer{
	layer = 2.98;
	pixel_x = -12;
	pixel_y = 21
	},
/turf/open/shuttle/vehicle/floor_3_5,
/area/interior/vehicle/lav)
"C" = (
/obj/structure/interior_wall/apc{
	icon_state = "front_1";
	name = "\improper LAV interior wall"
	},
/turf/open/void/vehicle,
/area/space)
"E" = (
/obj/structure/interior_wall/apc{
	icon_state = "rear_wheel_L";
	name = "\improper LAV interior wall"
	},
/turf/open/void/vehicle,
/area/space)
"F" = (
/obj/effect/landmark/interior/spawn/vehicle_driver_seat/armor{
	dir = 4
	},
/turf/open/shuttle/vehicle/floor_3_5,
/area/interior/vehicle/lav)
"G" = (
/obj/structure/interior_wall/apc{
	icon_state = "lav_corner";
	pixel_x = 3;
	name = "\improper LAV interior wall"
	},
/turf/open/shuttle/vehicle/floor_1_5,
/area/space)
"I" = (
/obj/structure/interior_wall/apc{
	icon_state = "wheel_front_top_2";
	pixel_x = 3;
	name = "\improper LAV interior wall"
	},
/turf/open/shuttle/vehicle/floor_1_5,
/area/space)
"J" = (
/obj/structure/interior_wall/apc{
	icon_state = "front_7";
	name = "\improper LAV interior wall"
	},
/turf/open/void/vehicle,
/area/space)
"K" = (
/obj/structure/interior_wall/apc{
	icon_state = "wall_1";
	opacity = 0;
	name = "\improper LAV interior wall"
	},
/turf/open/void/vehicle,
/area/space)
"O" = (
/obj/structure/bed/chair/vehicle{
	pixel_x = -8
	},
/obj/structure/bed/chair/vehicle{
	pixel_x = 8
	},
/obj/effect/landmark/interior/spawn/entrance{
	dir = 8;
	exit_type = /obj/structure/interior_exit/vehicle/lav/rear/left;
	pixel_x = -32;
	tag = "rear left"
	},
/turf/open/shuttle/vehicle/floor_3_5,
/area/interior/vehicle/lav)
"Q" = (
/obj/structure/interior_wall/apc{
	icon_state = "wall";
	opacity = 0;
	name = "\improper LAV interior wall"
	},
/turf/open/void/vehicle,
/area/space)
"R" = (
/obj/structure/interior_wall/apc{
	icon_state = "wall_7";
	name = "\improper LAV interior wall"
	},
/turf/open/shuttle/vehicle/floor_3_5,
/area/space)
"S" = (
/obj/structure/bed/chair/vehicle{
	pixel_x = -8
	},
/obj/structure/bed/chair/vehicle{
	pixel_x = 8
	},
/obj/effect/landmark/interior/spawn/interior_viewport{
	pixel_y = 23
	},
/turf/open/shuttle/vehicle/floor_3_5,
/area/interior/vehicle/lav)
"U" = (
/obj/structure/interior_wall/apc{
	icon_state = "rear_1";
	name = "\improper LAV interior wall"
	},
/turf/open/void/vehicle,
/area/space)
"V" = (
/obj/structure/interior_wall/apc{
	icon_state = "front_6";
	name = "\improper LAV interior wall"
	},
/turf/open/void/vehicle,
/area/space)
"W" = (
/obj/structure/bed/chair/vehicle{
	pixel_x = -8
	},
/obj/structure/extinguisher_cabinet/lifeboat{
	icon = 'icons/obj/vehicles/interiors/general.dmi';
	pixel_y = 28;
	pixel_x = -18
	},
/obj/structure/machinery/cm_vending/sorted/medical/wall_med/vehicle{
	pixel_y = 28;
	pixel_x = -4
	},
/turf/open/shuttle/vehicle/floor_3_5,
/area/interior/vehicle/lav)
"Z" = (
/obj/effect/landmark/interior/spawn/weapons_loader{
	pixel_x = 3;
	pixel_y = -1
	},
/turf/open/shuttle/vehicle/floor_3_5,
/area/interior/vehicle/lav)

(1,1,1) = {"
r
c
d
y
U
"}
(2,1,1) = {"
K
O
j
b
E
"}
(3,1,1) = {"
Q
S
k
a
h
"}
(4,1,1) = {"
Q
W
k
v
E
"}
(5,1,1) = {"
Q
B
t
Z
h
"}
(6,1,1) = {"
Q
e
G
w
E
"}
(7,1,1) = {"
u
F
I
R
h
"}
(8,1,1) = {"
V
n
J
J
C
"}
